   WWWWWWWW   WW|
 B   B   WBB BBW|
WB BW W  W BBB W|
W B W WBBWB B BW|
WB BW W  W B B W|
W B W W  W     W|
WB BW B WW     W|
W B WWW        W|
W     W WWWWWWWW|
WWWWW WWWW   B  |
    W       W   |
 WWWWWWWW WWWW  |
     WWWW   B BW|
BW W B  WB   B B|
  B W  B B WB BW|
   WW  B  WW B B|